##############
#.#.#.......%#
#.#.#.######.#
#o..#.######o#
#.###\..#....#
#.....######.#
##############

