##############
#.#.#.......%#
#.#.#.######.#
#o..#.######o#
#.###\..#....#
#.....###.##.#
#####.###.##.#
#.#.#........#
#.#.#.######.#
#o..#.######o#
#.###...#....#
#.....######.#
##############

